.................
.................
...@@@@@@........
..@######@.......
@@@#@@@@#@@@@@@@@
0###@@@@#@######9
@@@@...@#@#@@@@@@
.......@###@.....
........@@@......
.................
.................
.................
