..................
..................
....@@@@@@@@......
....@######@......
..@@@#@@@@#@@@@@..
.@0###@@@@#@###9@.
..@@@@@..@#@#@@@..
.........@###@....
.........@@@@@....
..................
..................
..................
