@@@@@@@@@@@@@@@@@@
0##@@@@@@@@@@@@@@@
@@##@@@@@@@@@@@@@@
@@@##@@@@@@@@@@@@@
@@@@##@@@@@@@@@@@@
@@@@@##@@@@@@@@@@@
@@@@@@##@@@@@@@@@@
@@@@@@@##@@@@@@@@@
@@@@@@@@######9@@@
@@@@@@@@@@@@@@@@@@
..................
..................
